1100000000000010
0100000000000010
0111m1c000000010
0100000000000010
0100000000000010
01p1h11c11000010
0m00000000000010
0100000000000010
0100000000000010
01111m1111111n10
0000000000000000