11000000000000n0
0100000000000010
0100000000000010
0101m11111111010
01p1111hh11110m0
010111m111111010
0100000000000010
0100000000000010
0100000000000010
01111m1111111110
0000000000000000