1000000000000000
111m11111111h110
0101010101010100
0111m1111111c110
0101010101010100
01111111111m1110
0101010101010100
0n111h1111m11110
0101010101010100
0111111m1111cc10
0000000000000000