1111000000000000
00010000000000n0
000m0000000000m0
0001p1cmh0000010
0001000000000010
0001000000000010
0001000000000010
00010000000000h0
00011m1111111110
0000000000000000